date,infected,exposed,active,recovered,deaths,diff_exposed,diff_active,diff_recovered,diff_deaths
2020-03-30,8254,9328,8254,0,0,0,1323,0,0
2020-03-31,9372,7470,9372,0,0,0,808,0,0
2020-04-01,10026,5996,10026,0,0,0,421,0,0
2020-04-02,10333,4827,10333,0,0,0,133,0,0
2020-04-03,10382,3897,10382,0,0,0,0,0,0
2020-04-04,10243,3158,10243,0,0,0,0,0,0
2020-04-05,9970,2568,9970,0,0,0,0,0,0
2020-04-06,9606,2097,9606,0,0,0,0,0,0
2020-04-07,9180,1721,9180,0,0,0,0,0,0
2020-04-08,8717,1419,8717,0,0,0,0,0,0
2020-04-09,8235,1176,8235,0,0,0,0,0,0
2020-04-10,7747,980,7747,0,0,0,0,0,0
2020-04-11,7263,821,7263,0,0,0,0,0,0
2020-04-12,6790,692,6790,0,0,0,0,0,0
2020-04-13,6334,587,6334,0,0,0,0,0,0
2020-04-14,5896,501,5896,0,0,0,0,0,0
2020-04-15,5479,430,5479,0,0,0,0,0,0
2020-04-16,5085,372,5085,0,0,0,0,0,0
2020-04-17,4714,323,4714,0,0,0,0,0,0
2020-04-18,4366,282,4366,0,0,0,0,0,0
2020-04-19,4040,248,4040,0,0,0,0,0,0
2020-04-20,3736,219,3736,0,0,0,0,0,0
2020-04-21,3452,194,3452,0,0,0,0,0,0
2020-04-22,3189,173,3189,0,0,0,0,0,0
2020-04-23,2944,154,2944,0,0,0,0,0,0
2020-04-24,2718,139,2718,0,0,0,0,0,0
2020-04-25,2507,125,2507,0,0,0,0,0,0
2020-04-26,2313,113,2313,0,0,0,0,0,0
2020-04-27,2133,102,2133,0,0,0,0,0,0
2020-04-28,1967,93,1967,0,0,0,0,0,0
2020-04-29,1813,84,1813,0,0,0,0,0,0
2020-04-30,1671,77,1671,0,0,0,0,0,0
2020-05-01,1540,70,1540,0,0,0,0,0,0
2020-05-02,1419,64,1419,0,0,0,0,0,0
2020-05-03,1308,58,1308,0,0,0,0,0,0
2020-05-04,1205,53,1205,0,0,0,0,0,0
2020-05-05,1110,49,1110,0,0,0,0,0,0
2020-05-06,1023,45,1023,0,0,0,0,0,0
2020-05-07,942,41,942,0,0,0,0,0,0
2020-05-08,868,38,868,0,0,0,0,0,0
2020-05-09,800,35,800,0,0,0,0,0,0
2020-05-10,737,32,737,0,0,0,0,0,0
2020-05-11,679,29,679,0,0,0,0,0,0
2020-05-12,625,27,625,0,0,0,0,0,0
2020-05-13,576,25,576,0,0,0,0,0,0
2020-05-14,530,23,530,0,0,0,0,0,0
2020-05-15,488,21,488,0,0,0,0,0,0
2020-05-16,450,19,450,0,0,0,0,0,0
2020-05-17,414,18,414,0,0,0,0,0,0
2020-05-18,382,16,382,0,0,0,0,0,0
2020-05-19,352,15,352,0,0,0,0,0,0
2020-05-20,324,14,324,0,0,0,0,0,0
2020-05-21,298,13,298,0,0,0,0,0,0
2020-05-22,275,12,275,0,0,0,0,0,0
2020-05-23,253,11,253,0,0,0,0,0,0
2020-05-24,233,10,233,0,0,0,0,0,0
2020-05-25,215,9,215,0,0,0,0,0,0
2020-05-26,198,8,198,0,0,0,0,0,0
2020-05-27,182,8,182,0,0,0,0,0,0
2020-05-28,168,7,168,0,0,0,0,0,0
2020-05-29,154,7,154,0,0,0,0,0,0
2020-05-30,142,6,142,0,0,0,0,0,0
2020-05-31,131,6,131,0,0,0,0,0,0
2020-06-01,121,5,121,0,0,0,0,0,0
2020-06-02,111,5,111,0,0,0,0,0,0
2020-06-03,102,4,102,0,0,0,0,0,0
2020-06-04,94,4,94,0,0,0,0,0,0
2020-06-05,87,4,87,0,0,0,0,0,0
2020-06-06,80,3,80,0,0,0,0,0,0
2020-06-07,74,3,74,0,0,0,0,0,0
2020-06-08,68,3,68,0,0,0,0,0,0
2020-06-09,62,3,62,0,0,0,0,0,0
2020-06-10,58,2,58,0,0,0,0,0,0
2020-06-11,53,2,53,0,0,0,0,0,0
2020-06-12,49,2,49,0,0,0,0,0,0
2020-06-13,45,2,45,0,0,0,0,0,0
2020-06-14,41,2,41,0,0,0,0,0,0
2020-06-15,38,2,38,0,0,0,0,0,0
2020-06-16,35,1,35,0,0,0,0,0,0
2020-06-17,32,1,32,0,0,0,0,0,0
2020-06-18,30,1,30,0,0,0,0,0,0
2020-06-19,27,1,27,0,0,0,0,0,0
2020-06-20,25,1,25,0,0,0,0,0,0
2020-06-21,23,1,23,0,0,0,0,0,0
2020-06-22,21,1,21,0,0,0,0,0,0
2020-06-23,20,1,20,0,0,0,0,0,0
2020-06-24,18,1,18,0,0,0,0,0,0
2020-06-25,17,1,17,0,0,0,0,0,0
2020-06-26,15,1,15,0,0,0,0,0,0
2020-06-27,14,1,14,0,0,0,0,0,0
2020-06-28,13,1,13,0,0,0,0,0,0
2020-06-29,12,1,12,0,0,0,0,0,0
2020-06-30,11,0,11,0,0,0,0,0,0
2020-07-01,10,0,10,0,0,0,0,0,0
2020-07-02,9,0,9,0,0,0,0,0,0
2020-07-03,9,0,9,0,0,0,0,0,0
2020-07-04,8,0,8,0,0,0,0,0,0
2020-07-05,7,0,7,0,0,0,0,0,0
2020-07-06,7,0,7,0,0,0,0,0,0
2020-07-07,6,0,6,0,0,0,0,0,0
2020-07-08,6,0,6,0,0,0,0,0,0
2020-07-09,5,0,5,0,0,0,0,0,0
2020-07-10,5,0,5,0,0,0,0,0,0
2020-07-11,4,0,4,0,0,0,0,0,0
2020-07-12,4,0,4,0,0,0,0,0,0
2020-07-13,4,0,4,0,0,0,0,0,0
2020-07-14,4,0,4,0,0,0,0,0,0
2020-07-15,3,0,3,0,0,0,0,0,0
2020-07-16,3,0,3,0,0,0,0,0,0
2020-07-17,3,0,3,0,0,0,0,0,0
2020-07-18,3,0,3,0,0,0,0,0,0
2020-07-19,2,0,2,0,0,0,0,0,0
2020-07-20,2,0,2,0,0,0,0,0,0
2020-07-21,2,0,2,0,0,0,0,0,0
2020-07-22,2,0,2,0,0,0,0,0,0
2020-07-23,2,0,2,0,0,0,0,0,0
2020-07-24,2,0,2,0,0,0,0,0,0
2020-07-25,1,0,1,0,0,0,0,0,0
2020-07-26,1,0,1,0,0,0,0,0,0
2020-07-27,1,0,1,0,0,0,0,0,0
2020-07-28,1,0,1,0,0,0,0,0,0
2020-07-29,1,0,1,0,0,0,0,0,0
2020-07-30,1,0,1,0,0,0,0,0,0
2020-07-31,1,0,1,0,0,0,0,0,0
2020-08-01,1,0,1,0,0,0,0,0,0
2020-08-02,1,0,1,0,0,0,0,0,0
2020-08-03,1,0,1,0,0,0,0,0,0
2020-08-04,1,0,1,0,0,0,0,0,0
2020-08-05,1,0,1,0,0,0,0,0,0
2020-08-06,1,0,1,0,0,0,0,0,0
2020-08-07,0,0,0,0,0,0,0,0,0
2020-08-08,0,0,0,0,0,0,0,0,0
2020-08-09,0,0,0,0,0,0,0,0,0
2020-08-10,0,0,0,0,0,0,0,0,0
2020-08-11,0,0,0,0,0,0,0,0,0
2020-08-12,0,0,0,0,0,0,0,0,0
2020-08-13,0,0,0,0,0,0,0,0,0
2020-08-14,0,0,0,0,0,0,0,0,0
2020-08-15,0,0,0,0,0,0,0,0,0
2020-08-16,0,0,0,0,0,0,0,0,0
2020-08-17,0,0,0,0,0,0,0,0,0
2020-08-18,0,0,0,0,0,0,0,0,0
2020-08-19,0,0,0,0,0,0,0,0,0
2020-08-20,0,0,0,0,0,0,0,0,0
2020-08-21,0,0,0,0,0,0,0,0,0
2020-08-22,0,0,0,0,0,0,0,0,0
2020-08-23,0,0,0,0,0,0,0,0,0
2020-08-24,0,0,0,0,0,0,0,0,0
2020-08-25,0,0,0,0,0,0,0,0,0
2020-08-26,0,0,0,0,0,0,0,0,0
2020-08-27,0,0,0,0,0,0,0,0,0
2020-08-28,0,0,0,0,0,0,0,0,0
2020-08-29,0,0,0,0,0,0,0,0,0
2020-08-30,0,0,0,0,0,0,0,0,0
2020-08-31,0,0,0,0,0,0,0,0,0
2020-09-01,0,0,0,0,0,0,0,0,0
2020-09-02,0,0,0,0,0,0,0,0,0
2020-09-03,0,0,0,0,0,0,0,0,0
2020-09-04,0,0,0,0,0,0,0,0,0
2020-09-05,0,0,0,0,0,0,0,0,0
2020-09-06,0,0,0,0,0,0,0,0,0
2020-09-07,0,0,0,0,0,0,0,0,0
2020-09-08,0,0,0,0,0,0,0,0,0
2020-09-09,0,0,0,0,0,0,0,0,0
2020-09-10,0,0,0,0,0,0,0,0,0
2020-09-11,0,0,0,0,0,0,0,0,0
2020-09-12,0,0,0,0,0,0,0,0,0
2020-09-13,0,0,0,0,0,0,0,0,0
2020-09-14,0,0,0,0,0,0,0,0,0
2020-09-15,0,0,0,0,0,0,0,0,0
2020-09-16,0,0,0,0,0,0,0,0,0
2020-09-17,0,0,0,0,0,0,0,0,0
2020-09-18,0,0,0,0,0,0,0,0,0
2020-09-19,0,0,0,0,0,0,0,0,0
2020-09-20,0,0,0,0,0,0,0,0,0
2020-09-21,0,0,0,0,0,0,0,0,0
2020-09-22,0,0,0,0,0,0,0,0,0
2020-09-23,0,0,0,0,0,0,0,0,0
2020-09-24,0,0,0,0,0,0,0,0,0
2020-09-25,0,0,0,0,0,0,0,0,0
2020-09-26,0,0,0,0,0,0,0,0,0
2020-09-27,0,0,0,0,0,0,0,0,0
2020-09-28,0,0,0,0,0,0,0,0,0
2020-09-29,0,0,0,0,0,0,0,0,0
2020-09-30,0,0,0,0,0,0,0,0,0
2020-10-01,0,0,0,0,0,0,0,0,0
2020-10-02,0,0,0,0,0,0,0,0,0
2020-10-03,0,0,0,0,0,0,0,0,0
2020-10-04,0,0,0,0,0,0,0,0,0
2020-10-05,0,0,0,0,0,0,0,0,0
2020-10-06,0,0,0,0,0,0,0,0,0
2020-10-07,0,0,0,0,0,0,0,0,0
2020-10-08,0,0,0,0,0,0,0,0,0
2020-10-09,0,0,0,0,0,0,0,0,0
2020-10-10,0,0,0,0,0,0,0,0,0
2020-10-11,0,0,0,0,0,0,0,0,0
2020-10-12,0,0,0,0,0,0,0,0,0
2020-10-13,0,0,0,0,0,0,0,0,0
2020-10-14,0,0,0,0,0,0,0,0,0
2020-10-15,0,0,0,0,0,0,0,0,0
2020-10-16,0,0,0,0,0,0,0,0,0
2020-10-17,0,0,0,0,0,0,0,0,0
2020-10-18,0,0,0,0,0,0,0,0,0
2020-10-19,0,0,0,0,0,0,0,0,0
2020-10-20,0,0,0,0,0,0,0,0,0
2020-10-21,0,0,0,0,0,0,0,0,0
2020-10-22,0,0,0,0,0,0,0,0,0
2020-10-23,0,0,0,0,0,0,0,0,0
2020-10-24,0,0,0,0,0,0,0,0,0
2020-10-25,0,0,0,0,0,0,0,0,0
2020-10-26,0,0,0,0,0,0,0,0,0
2020-10-27,0,0,0,0,0,0,0,0,0
2020-10-28,0,0,0,0,0,0,0,0,0
2020-10-29,0,0,0,0,0,0,0,0,0
2020-10-30,0,0,0,0,0,0,0,0,0
2020-10-31,0,0,0,0,0,0,0,0,0
2020-11-01,0,0,0,0,0,0,0,0,0
2020-11-02,0,0,0,0,0,0,0,0,0
2020-11-03,0,0,0,0,0,0,0,0,0
2020-11-04,0,0,0,0,0,0,0,0,0
2020-11-05,0,0,0,0,0,0,0,0,0
2020-11-06,0,0,0,0,0,0,0,0,0
2020-11-07,0,0,0,0,0,0,0,0,0
2020-11-08,0,0,0,0,0,0,0,0,0
2020-11-09,0,0,0,0,0,0,0,0,0
2020-11-10,0,0,0,0,0,0,0,0,0
2020-11-11,0,0,0,0,0,0,0,0,0
2020-11-12,0,0,0,0,0,0,0,0,0
2020-11-13,0,0,0,0,0,0,0,0,0
2020-11-14,0,0,0,0,0,0,0,0,0
2020-11-15,0,0,0,0,0,0,0,0,0
2020-11-16,0,0,0,0,0,0,0,0,0
2020-11-17,0,0,0,0,0,0,0,0,0
2020-11-18,0,0,0,0,0,0,0,0,0
2020-11-19,0,0,0,0,0,0,0,0,0
2020-11-20,0,0,0,0,0,0,0,0,0
2020-11-21,0,0,0,0,0,0,0,0,0
2020-11-22,0,0,0,0,0,0,0,0,0
2020-11-23,0,0,0,0,0,0,0,0,0
2020-11-24,0,0,0,0,0,0,0,0,0
2020-11-25,0,0,0,0,0,0,0,0,0
2020-11-26,0,0,0,0,0,0,0,0,0
2020-11-27,0,0,0,0,0,0,0,0,0
2020-11-28,0,0,0,0,0,0,0,0,0
2020-11-29,0,0,0,0,0,0,0,0,0
2020-11-30,0,0,0,0,0,0,0,0,0
2020-12-01,0,0,0,0,0,0,0,0,0
2020-12-02,0,0,0,0,0,0,0,0,0
2020-12-03,0,0,0,0,0,0,0,0,0
2020-12-04,0,0,0,0,0,0,0,0,0
2020-12-05,0,0,0,0,0,0,0,0,0
2020-12-06,0,0,0,0,0,0,0,0,0
2020-12-07,0,0,0,0,0,0,0,0,0
2020-12-08,0,0,0,0,0,0,0,0,0
2020-12-09,0,0,0,0,0,0,0,0,0
2020-12-10,0,0,0,0,0,0,0,0,0
2020-12-11,0,0,0,0,0,0,0,0,0
2020-12-12,0,0,0,0,0,0,0,0,0
2020-12-13,0,0,0,0,0,0,0,0,0
2020-12-14,0,0,0,0,0,0,0,0,0
2020-12-15,0,0,0,0,0,0,0,0,0
2020-12-16,0,0,0,0,0,0,0,0,0
2020-12-17,0,0,0,0,0,0,0,0,0
2020-12-18,0,0,0,0,0,0,0,0,0
2020-12-19,0,0,0,0,0,0,0,0,0
2020-12-20,0,0,0,0,0,0,0,0,0
2020-12-21,0,0,0,0,0,0,0,0,0
2020-12-22,0,0,0,0,0,0,0,0,0
2020-12-23,0,0,0,0,0,0,0,0,0
2020-12-24,0,0,0,0,0,0,0,0,0
2020-12-25,0,0,0,0,0,0,0,0,0
2020-12-26,0,0,0,0,0,0,0,0,0
2020-12-27,0,0,0,0,0,0,0,0,0
2020-12-28,0,0,0,0,0,0,0,0,0
2020-12-29,0,0,0,0,0,0,0,0,0
2020-12-30,0,0,0,0,0,0,0,0,0
2020-12-31,0,0,0,0,0,0,0,0,0
2021-01-01,0,0,0,0,0,0,0,0,0
2021-01-02,0,0,0,0,0,0,0,0,0
2021-01-03,0,0,0,0,0,0,0,0,0
2021-01-04,0,0,0,0,0,0,0,0,0
2021-01-05,0,0,0,0,0,0,0,0,0
2021-01-06,0,0,0,0,0,0,0,0,0
2021-01-07,0,0,0,0,0,0,0,0,0
2021-01-08,0,0,0,0,0,0,0,0,0
2021-01-09,0,0,0,0,0,0,0,0,0
2021-01-10,0,0,0,0,0,0,0,0,0
2021-01-11,0,0,0,0,0,0,0,0,0
2021-01-12,0,0,0,0,0,0,0,0,0
2021-01-13,0,0,0,0,0,0,0,0,0
2021-01-14,0,0,0,0,0,0,0,0,0
2021-01-15,0,0,0,0,0,0,0,0,0
2021-01-16,0,0,0,0,0,0,0,0,0
2021-01-17,0,0,0,0,0,0,0,0,0
2021-01-18,0,0,0,0,0,0,0,0,0
2021-01-19,0,0,0,0,0,0,0,0,0
2021-01-20,0,0,0,0,0,0,0,0,0
2021-01-21,0,0,0,0,0,0,0,0,0
2021-01-22,0,0,0,0,0,0,0,0,0
2021-01-23,0,0,0,0,0,0,0,0,0
2021-01-24,0,0,0,0,0,0,0,0,0
2021-01-25,0,0,0,0,0,0,0,0,0
2021-01-26,0,0,0,0,0,0,0,0,0
2021-01-27,0,0,0,0,0,0,0,0,0
2021-01-28,0,0,0,0,0,0,0,0,0
2021-01-29,0,0,0,0,0,0,0,0,0
2021-01-30,0,0,0,0,0,0,0,0,0
2021-01-31,0,0,0,0,0,0,0,0,0
2021-02-01,0,0,0,0,0,0,0,0,0
2021-02-02,0,0,0,0,0,0,0,0,0
2021-02-03,0,0,0,0,0,0,0,0,0
2021-02-04,0,0,0,0,0,0,0,0,0
2021-02-05,0,0,0,0,0,0,0,0,0
2021-02-06,0,0,0,0,0,0,0,0,0
2021-02-07,0,0,0,0,0,0,0,0,0
2021-02-08,0,0,0,0,0,0,0,0,0
2021-02-09,0,0,0,0,0,0,0,0,0
2021-02-10,0,0,0,0,0,0,0,0,0
2021-02-11,0,0,0,0,0,0,0,0,0
2021-02-12,0,0,0,0,0,0,0,0,0
2021-02-13,0,0,0,0,0,0,0,0,0
2021-02-14,0,0,0,0,0,0,0,0,0
2021-02-15,0,0,0,0,0,0,0,0,0
2021-02-16,0,0,0,0,0,0,0,0,0
2021-02-17,0,0,0,0,0,0,0,0,0
2021-02-18,0,0,0,0,0,0,0,0,0
2021-02-19,0,0,0,0,0,0,0,0,0
2021-02-20,0,0,0,0,0,0,0,0,0
2021-02-21,0,0,0,0,0,0,0,0,0
2021-02-22,0,0,0,0,0,0,0,0,0
2021-02-23,0,0,0,0,0,0,0,0,0
2021-02-24,0,0,0,0,0,0,0,0,0
2021-02-25,0,0,0,0,0,0,0,0,0
2021-02-26,0,0,0,0,0,0,0,0,0
2021-02-27,0,0,0,0,0,0,0,0,0
2021-02-28,0,0,0,0,0,0,0,0,0
2021-03-01,0,0,0,0,0,0,0,0,0
2021-03-02,0,0,0,0,0,0,0,0,0
2021-03-03,0,0,0,0,0,0,0,0,0
2021-03-04,0,0,0,0,0,0,0,0,0
2021-03-05,0,0,0,0,0,0,0,0,0
2021-03-06,0,0,0,0,0,0,0,0,0
2021-03-07,0,0,0,0,0,0,0,0,0
2021-03-08,0,0,0,0,0,0,0,0,0
2021-03-09,0,0,0,0,0,0,0,0,0
2021-03-10,0,0,0,0,0,0,0,0,0
2021-03-11,0,0,0,0,0,0,0,0,0
2021-03-12,0,0,0,0,0,0,0,0,0
2021-03-13,0,0,0,0,0,0,0,0,0
2021-03-14,0,0,0,0,0,0,0,0,0
2021-03-15,0,0,0,0,0,0,0,0,0
2021-03-16,0,0,0,0,0,0,0,0,0
2021-03-17,0,0,0,0,0,0,0,0,0
2021-03-18,0,0,0,0,0,0,0,0,0
2021-03-19,0,0,0,0,0,0,0,0,0
2021-03-20,0,0,0,0,0,0,0,0,0
2021-03-21,0,0,0,0,0,0,0,0,0
2021-03-22,0,0,0,0,0,0,0,0,0
2021-03-23,0,0,0,0,0,0,0,0,0
2021-03-24,0,0,0,0,0,0,0,0,0
2021-03-25,0,0,0,0,0,0,0,0,0
