Date,Infected,Exposed,Active,Recovered,Deaths,Diff Exposed,Diff Active,Diff Recovered,Diff Deaths
2020-03-31,10208,11091,10208,0,0,0,1247,0,0
2020-04-01,11265,9130,11265,0,0,0,766,0,0
2020-04-02,11885,7532,11885,0,0,0,396,0,0
2020-04-03,12169,6227,12169,0,0,0,115,0,0
2020-04-04,12200,5161,12200,0,0,0,0,0,0
2020-04-05,12040,4288,12040,0,0,0,0,0,0
2020-04-06,11741,3574,11741,0,0,0,0,0,0
2020-04-07,11342,2987,11342,0,0,0,0,0,0
2020-04-08,10876,2505,10876,0,0,0,0,0,0
2020-04-09,10365,2108,10365,0,0,0,0,0,0
2020-04-10,9829,1781,9829,0,0,0,0,0,0
2020-04-11,9283,1510,9283,0,0,0,0,0,0
2020-04-12,8736,1285,8736,0,0,0,0,0,0
2020-04-13,8198,1099,8198,0,0,0,0,0,0
2020-04-14,7675,943,7675,0,0,0,0,0,0
2020-04-15,7169,813,7169,0,0,0,0,0,0
2020-04-16,6685,704,6685,0,0,0,0,0,0
2020-04-17,6224,612,6224,0,0,0,0,0,0
2020-04-18,5787,534,5787,0,0,0,0,0,0
2020-04-19,5375,468,5375,0,0,0,0,0,0
2020-04-20,4987,412,4987,0,0,0,0,0,0
2020-04-21,4624,364,4624,0,0,0,0,0,0
2020-04-22,4283,322,4283,0,0,0,0,0,0
2020-04-23,3965,287,3965,0,0,0,0,0,0
2020-04-24,3669,256,3669,0,0,0,0,0,0
2020-04-25,3393,229,3393,0,0,0,0,0,0
2020-04-26,3137,206,3137,0,0,0,0,0,0
2020-04-27,2899,185,2899,0,0,0,0,0,0
2020-04-28,2678,167,2678,0,0,0,0,0,0
2020-04-29,2473,151,2473,0,0,0,0,0,0
2020-04-30,2283,137,2283,0,0,0,0,0,0
2020-05-01,2108,124,2108,0,0,0,0,0,0
2020-05-02,1945,113,1945,0,0,0,0,0,0
2020-05-03,1795,103,1795,0,0,0,0,0,0
2020-05-04,1656,94,1656,0,0,0,0,0,0
2020-05-05,1528,86,1528,0,0,0,0,0,0
2020-05-06,1409,78,1409,0,0,0,0,0,0
2020-05-07,1300,72,1300,0,0,0,0,0,0
2020-05-08,1199,66,1199,0,0,0,0,0,0
2020-05-09,1105,60,1105,0,0,0,0,0,0
2020-05-10,1019,55,1019,0,0,0,0,0,0
2020-05-11,940,51,940,0,0,0,0,0,0
2020-05-12,867,46,867,0,0,0,0,0,0
2020-05-13,799,43,799,0,0,0,0,0,0
2020-05-14,737,39,737,0,0,0,0,0,0
2020-05-15,679,36,679,0,0,0,0,0,0
2020-05-16,626,33,626,0,0,0,0,0,0
2020-05-17,577,30,577,0,0,0,0,0,0
2020-05-18,532,28,532,0,0,0,0,0,0
2020-05-19,490,26,490,0,0,0,0,0,0
2020-05-20,452,24,452,0,0,0,0,0,0
2020-05-21,417,22,417,0,0,0,0,0,0
2020-05-22,384,20,384,0,0,0,0,0,0
2020-05-23,354,19,354,0,0,0,0,0,0
2020-05-24,326,17,326,0,0,0,0,0,0
2020-05-25,301,16,301,0,0,0,0,0,0
2020-05-26,277,14,277,0,0,0,0,0,0
2020-05-27,256,13,256,0,0,0,0,0,0
2020-05-28,236,12,236,0,0,0,0,0,0
2020-05-29,217,11,217,0,0,0,0,0,0
2020-05-30,200,10,200,0,0,0,0,0,0
2020-05-31,184,10,184,0,0,0,0,0,0
2020-06-01,170,9,170,0,0,0,0,0,0
2020-06-02,157,8,157,0,0,0,0,0,0
2020-06-03,144,8,144,0,0,0,0,0,0
2020-06-04,133,7,133,0,0,0,0,0,0
2020-06-05,123,6,123,0,0,0,0,0,0
2020-06-06,113,6,113,0,0,0,0,0,0
2020-06-07,104,5,104,0,0,0,0,0,0
2020-06-08,96,5,96,0,0,0,0,0,0
2020-06-09,89,5,89,0,0,0,0,0,0
2020-06-10,82,4,82,0,0,0,0,0,0
2020-06-11,75,4,75,0,0,0,0,0,0
2020-06-12,69,4,69,0,0,0,0,0,0
2020-06-13,64,3,64,0,0,0,0,0,0
2020-06-14,59,3,59,0,0,0,0,0,0
2020-06-15,54,3,54,0,0,0,0,0,0
2020-06-16,50,3,50,0,0,0,0,0,0
2020-06-17,46,2,46,0,0,0,0,0,0
2020-06-18,42,2,42,0,0,0,0,0,0
2020-06-19,39,2,39,0,0,0,0,0,0
2020-06-20,36,2,36,0,0,0,0,0,0
2020-06-21,33,2,33,0,0,0,0,0,0
2020-06-22,31,2,31,0,0,0,0,0,0
2020-06-23,28,1,28,0,0,0,0,0,0
2020-06-24,26,1,26,0,0,0,0,0,0
2020-06-25,24,1,24,0,0,0,0,0,0
2020-06-26,22,1,22,0,0,0,0,0,0
2020-06-27,20,1,20,0,0,0,0,0,0
2020-06-28,19,1,19,0,0,0,0,0,0
2020-06-29,17,1,17,0,0,0,0,0,0
2020-06-30,16,1,16,0,0,0,0,0,0
2020-07-01,15,1,15,0,0,0,0,0,0
2020-07-02,14,1,14,0,0,0,0,0,0
2020-07-03,13,1,13,0,0,0,0,0,0
2020-07-04,12,1,12,0,0,0,0,0,0
2020-07-05,11,1,11,0,0,0,0,0,0
2020-07-06,10,1,10,0,0,0,0,0,0
2020-07-07,9,0,9,0,0,0,0,0,0
2020-07-08,8,0,8,0,0,0,0,0,0
2020-07-09,8,0,8,0,0,0,0,0,0
2020-07-10,7,0,7,0,0,0,0,0,0
2020-07-11,7,0,7,0,0,0,0,0,0
2020-07-12,6,0,6,0,0,0,0,0,0
2020-07-13,6,0,6,0,0,0,0,0,0
2020-07-14,5,0,5,0,0,0,0,0,0
2020-07-15,5,0,5,0,0,0,0,0,0
2020-07-16,4,0,4,0,0,0,0,0,0
2020-07-17,4,0,4,0,0,0,0,0,0
2020-07-18,4,0,4,0,0,0,0,0,0
2020-07-19,3,0,3,0,0,0,0,0,0
2020-07-20,3,0,3,0,0,0,0,0,0
2020-07-21,3,0,3,0,0,0,0,0,0
2020-07-22,3,0,3,0,0,0,0,0,0
2020-07-23,2,0,2,0,0,0,0,0,0
2020-07-24,2,0,2,0,0,0,0,0,0
2020-07-25,2,0,2,0,0,0,0,0,0
2020-07-26,2,0,2,0,0,0,0,0,0
2020-07-27,2,0,2,0,0,0,0,0,0
2020-07-28,2,0,2,0,0,0,0,0,0
2020-07-29,2,0,2,0,0,0,0,0,0
2020-07-30,1,0,1,0,0,0,0,0,0
2020-07-31,1,0,1,0,0,0,0,0,0
2020-08-01,1,0,1,0,0,0,0,0,0
2020-08-02,1,0,1,0,0,0,0,0,0
2020-08-03,1,0,1,0,0,0,0,0,0
2020-08-04,1,0,1,0,0,0,0,0,0
2020-08-05,1,0,1,0,0,0,0,0,0
2020-08-06,1,0,1,0,0,0,0,0,0
2020-08-07,1,0,1,0,0,0,0,0,0
2020-08-08,1,0,1,0,0,0,0,0,0
2020-08-09,1,0,1,0,0,0,0,0,0
2020-08-10,1,0,1,0,0,0,0,0,0
2020-08-11,1,0,1,0,0,0,0,0,0
2020-08-12,0,0,0,0,0,0,0,0,0
2020-08-13,0,0,0,0,0,0,0,0,0
2020-08-14,0,0,0,0,0,0,0,0,0
2020-08-15,0,0,0,0,0,0,0,0,0
2020-08-16,0,0,0,0,0,0,0,0,0
2020-08-17,0,0,0,0,0,0,0,0,0
2020-08-18,0,0,0,0,0,0,0,0,0
2020-08-19,0,0,0,0,0,0,0,0,0
2020-08-20,0,0,0,0,0,0,0,0,0
2020-08-21,0,0,0,0,0,0,0,0,0
2020-08-22,0,0,0,0,0,0,0,0,0
2020-08-23,0,0,0,0,0,0,0,0,0
2020-08-24,0,0,0,0,0,0,0,0,0
2020-08-25,0,0,0,0,0,0,0,0,0
2020-08-26,0,0,0,0,0,0,0,0,0
2020-08-27,0,0,0,0,0,0,0,0,0
2020-08-28,0,0,0,0,0,0,0,0,0
2020-08-29,0,0,0,0,0,0,0,0,0
2020-08-30,0,0,0,0,0,0,0,0,0
2020-08-31,0,0,0,0,0,0,0,0,0
2020-09-01,0,0,0,0,0,0,0,0,0
2020-09-02,0,0,0,0,0,0,0,0,0
2020-09-03,0,0,0,0,0,0,0,0,0
2020-09-04,0,0,0,0,0,0,0,0,0
2020-09-05,0,0,0,0,0,0,0,0,0
2020-09-06,0,0,0,0,0,0,0,0,0
2020-09-07,0,0,0,0,0,0,0,0,0
2020-09-08,0,0,0,0,0,0,0,0,0
2020-09-09,0,0,0,0,0,0,0,0,0
2020-09-10,0,0,0,0,0,0,0,0,0
2020-09-11,0,0,0,0,0,0,0,0,0
2020-09-12,0,0,0,0,0,0,0,0,0
2020-09-13,0,0,0,0,0,0,0,0,0
2020-09-14,0,0,0,0,0,0,0,0,0
2020-09-15,0,0,0,0,0,0,0,0,0
2020-09-16,0,0,0,0,0,0,0,0,0
2020-09-17,0,0,0,0,0,0,0,0,0
2020-09-18,0,0,0,0,0,0,0,0,0
2020-09-19,0,0,0,0,0,0,0,0,0
2020-09-20,0,0,0,0,0,0,0,0,0
2020-09-21,0,0,0,0,0,0,0,0,0
2020-09-22,0,0,0,0,0,0,0,0,0
2020-09-23,0,0,0,0,0,0,0,0,0
2020-09-24,0,0,0,0,0,0,0,0,0
2020-09-25,0,0,0,0,0,0,0,0,0
2020-09-26,0,0,0,0,0,0,0,0,0
2020-09-27,0,0,0,0,0,0,0,0,0
2020-09-28,0,0,0,0,0,0,0,0,0
2020-09-29,0,0,0,0,0,0,0,0,0
2020-09-30,0,0,0,0,0,0,0,0,0
2020-10-01,0,0,0,0,0,0,0,0,0
2020-10-02,0,0,0,0,0,0,0,0,0
2020-10-03,0,0,0,0,0,0,0,0,0
2020-10-04,0,0,0,0,0,0,0,0,0
2020-10-05,0,0,0,0,0,0,0,0,0
2020-10-06,0,0,0,0,0,0,0,0,0
2020-10-07,0,0,0,0,0,0,0,0,0
2020-10-08,0,0,0,0,0,0,0,0,0
2020-10-09,0,0,0,0,0,0,0,0,0
2020-10-10,0,0,0,0,0,0,0,0,0
2020-10-11,0,0,0,0,0,0,0,0,0
2020-10-12,0,0,0,0,0,0,0,0,0
2020-10-13,0,0,0,0,0,0,0,0,0
2020-10-14,0,0,0,0,0,0,0,0,0
2020-10-15,0,0,0,0,0,0,0,0,0
2020-10-16,0,0,0,0,0,0,0,0,0
2020-10-17,0,0,0,0,0,0,0,0,0
2020-10-18,0,0,0,0,0,0,0,0,0
2020-10-19,0,0,0,0,0,0,0,0,0
2020-10-20,0,0,0,0,0,0,0,0,0
2020-10-21,0,0,0,0,0,0,0,0,0
2020-10-22,0,0,0,0,0,0,0,0,0
2020-10-23,0,0,0,0,0,0,0,0,0
2020-10-24,0,0,0,0,0,0,0,0,0
2020-10-25,0,0,0,0,0,0,0,0,0
2020-10-26,0,0,0,0,0,0,0,0,0
2020-10-27,0,0,0,0,0,0,0,0,0
2020-10-28,0,0,0,0,0,0,0,0,0
2020-10-29,0,0,0,0,0,0,0,0,0
2020-10-30,0,0,0,0,0,0,0,0,0
2020-10-31,0,0,0,0,0,0,0,0,0
2020-11-01,0,0,0,0,0,0,0,0,0
2020-11-02,0,0,0,0,0,0,0,0,0
2020-11-03,0,0,0,0,0,0,0,0,0
2020-11-04,0,0,0,0,0,0,0,0,0
2020-11-05,0,0,0,0,0,0,0,0,0
2020-11-06,0,0,0,0,0,0,0,0,0
2020-11-07,0,0,0,0,0,0,0,0,0
2020-11-08,0,0,0,0,0,0,0,0,0
2020-11-09,0,0,0,0,0,0,0,0,0
2020-11-10,0,0,0,0,0,0,0,0,0
2020-11-11,0,0,0,0,0,0,0,0,0
2020-11-12,0,0,0,0,0,0,0,0,0
2020-11-13,0,0,0,0,0,0,0,0,0
2020-11-14,0,0,0,0,0,0,0,0,0
2020-11-15,0,0,0,0,0,0,0,0,0
2020-11-16,0,0,0,0,0,0,0,0,0
2020-11-17,0,0,0,0,0,0,0,0,0
2020-11-18,0,0,0,0,0,0,0,0,0
2020-11-19,0,0,0,0,0,0,0,0,0
2020-11-20,0,0,0,0,0,0,0,0,0
2020-11-21,0,0,0,0,0,0,0,0,0
2020-11-22,0,0,0,0,0,0,0,0,0
2020-11-23,0,0,0,0,0,0,0,0,0
2020-11-24,0,0,0,0,0,0,0,0,0
2020-11-25,0,0,0,0,0,0,0,0,0
2020-11-26,0,0,0,0,0,0,0,0,0
2020-11-27,0,0,0,0,0,0,0,0,0
2020-11-28,0,0,0,0,0,0,0,0,0
2020-11-29,0,0,0,0,0,0,0,0,0
2020-11-30,0,0,0,0,0,0,0,0,0
2020-12-01,0,0,0,0,0,0,0,0,0
2020-12-02,0,0,0,0,0,0,0,0,0
2020-12-03,0,0,0,0,0,0,0,0,0
2020-12-04,0,0,0,0,0,0,0,0,0
2020-12-05,0,0,0,0,0,0,0,0,0
2020-12-06,0,0,0,0,0,0,0,0,0
2020-12-07,0,0,0,0,0,0,0,0,0
2020-12-08,0,0,0,0,0,0,0,0,0
2020-12-09,0,0,0,0,0,0,0,0,0
2020-12-10,0,0,0,0,0,0,0,0,0
2020-12-11,0,0,0,0,0,0,0,0,0
2020-12-12,0,0,0,0,0,0,0,0,0
2020-12-13,0,0,0,0,0,0,0,0,0
2020-12-14,0,0,0,0,0,0,0,0,0
2020-12-15,0,0,0,0,0,0,0,0,0
2020-12-16,0,0,0,0,0,0,0,0,0
2020-12-17,0,0,0,0,0,0,0,0,0
2020-12-18,0,0,0,0,0,0,0,0,0
2020-12-19,0,0,0,0,0,0,0,0,0
2020-12-20,0,0,0,0,0,0,0,0,0
2020-12-21,0,0,0,0,0,0,0,0,0
2020-12-22,0,0,0,0,0,0,0,0,0
2020-12-23,0,0,0,0,0,0,0,0,0
2020-12-24,0,0,0,0,0,0,0,0,0
2020-12-25,0,0,0,0,0,0,0,0,0
2020-12-26,0,0,0,0,0,0,0,0,0
2020-12-27,0,0,0,0,0,0,0,0,0
2020-12-28,0,0,0,0,0,0,0,0,0
2020-12-29,0,0,0,0,0,0,0,0,0
2020-12-30,0,0,0,0,0,0,0,0,0
2020-12-31,0,0,0,0,0,0,0,0,0
2021-01-01,0,0,0,0,0,0,0,0,0
2021-01-02,0,0,0,0,0,0,0,0,0
2021-01-03,0,0,0,0,0,0,0,0,0
2021-01-04,0,0,0,0,0,0,0,0,0
2021-01-05,0,0,0,0,0,0,0,0,0
2021-01-06,0,0,0,0,0,0,0,0,0
2021-01-07,0,0,0,0,0,0,0,0,0
2021-01-08,0,0,0,0,0,0,0,0,0
2021-01-09,0,0,0,0,0,0,0,0,0
2021-01-10,0,0,0,0,0,0,0,0,0
2021-01-11,0,0,0,0,0,0,0,0,0
2021-01-12,0,0,0,0,0,0,0,0,0
2021-01-13,0,0,0,0,0,0,0,0,0
2021-01-14,0,0,0,0,0,0,0,0,0
2021-01-15,0,0,0,0,0,0,0,0,0
2021-01-16,0,0,0,0,0,0,0,0,0
2021-01-17,0,0,0,0,0,0,0,0,0
2021-01-18,0,0,0,0,0,0,0,0,0
2021-01-19,0,0,0,0,0,0,0,0,0
2021-01-20,0,0,0,0,0,0,0,0,0
2021-01-21,0,0,0,0,0,0,0,0,0
2021-01-22,0,0,0,0,0,0,0,0,0
2021-01-23,0,0,0,0,0,0,0,0,0
2021-01-24,0,0,0,0,0,0,0,0,0
2021-01-25,0,0,0,0,0,0,0,0,0
2021-01-26,0,0,0,0,0,0,0,0,0
2021-01-27,0,0,0,0,0,0,0,0,0
2021-01-28,0,0,0,0,0,0,0,0,0
2021-01-29,0,0,0,0,0,0,0,0,0
2021-01-30,0,0,0,0,0,0,0,0,0
2021-01-31,0,0,0,0,0,0,0,0,0
2021-02-01,0,0,0,0,0,0,0,0,0
2021-02-02,0,0,0,0,0,0,0,0,0
2021-02-03,0,0,0,0,0,0,0,0,0
2021-02-04,0,0,0,0,0,0,0,0,0
2021-02-05,0,0,0,0,0,0,0,0,0
2021-02-06,0,0,0,0,0,0,0,0,0
2021-02-07,0,0,0,0,0,0,0,0,0
2021-02-08,0,0,0,0,0,0,0,0,0
2021-02-09,0,0,0,0,0,0,0,0,0
2021-02-10,0,0,0,0,0,0,0,0,0
2021-02-11,0,0,0,0,0,0,0,0,0
2021-02-12,0,0,0,0,0,0,0,0,0
2021-02-13,0,0,0,0,0,0,0,0,0
2021-02-14,0,0,0,0,0,0,0,0,0
2021-02-15,0,0,0,0,0,0,0,0,0
2021-02-16,0,0,0,0,0,0,0,0,0
2021-02-17,0,0,0,0,0,0,0,0,0
2021-02-18,0,0,0,0,0,0,0,0,0
2021-02-19,0,0,0,0,0,0,0,0,0
2021-02-20,0,0,0,0,0,0,0,0,0
2021-02-21,0,0,0,0,0,0,0,0,0
2021-02-22,0,0,0,0,0,0,0,0,0
2021-02-23,0,0,0,0,0,0,0,0,0
2021-02-24,0,0,0,0,0,0,0,0,0
2021-02-25,0,0,0,0,0,0,0,0,0
2021-02-26,0,0,0,0,0,0,0,0,0
2021-02-27,0,0,0,0,0,0,0,0,0
2021-02-28,0,0,0,0,0,0,0,0,0
2021-03-01,0,0,0,0,0,0,0,0,0
2021-03-02,0,0,0,0,0,0,0,0,0
2021-03-03,0,0,0,0,0,0,0,0,0
2021-03-04,0,0,0,0,0,0,0,0,0
2021-03-05,0,0,0,0,0,0,0,0,0
2021-03-06,0,0,0,0,0,0,0,0,0
2021-03-07,0,0,0,0,0,0,0,0,0
2021-03-08,0,0,0,0,0,0,0,0,0
2021-03-09,0,0,0,0,0,0,0,0,0
2021-03-10,0,0,0,0,0,0,0,0,0
2021-03-11,0,0,0,0,0,0,0,0,0
2021-03-12,0,0,0,0,0,0,0,0,0
2021-03-13,0,0,0,0,0,0,0,0,0
2021-03-14,0,0,0,0,0,0,0,0,0
2021-03-15,0,0,0,0,0,0,0,0,0
2021-03-16,0,0,0,0,0,0,0,0,0
2021-03-17,0,0,0,0,0,0,0,0,0
2021-03-18,0,0,0,0,0,0,0,0,0
2021-03-19,0,0,0,0,0,0,0,0,0
2021-03-20,0,0,0,0,0,0,0,0,0
2021-03-21,0,0,0,0,0,0,0,0,0
2021-03-22,0,0,0,0,0,0,0,0,0
2021-03-23,0,0,0,0,0,0,0,0,0
2021-03-24,0,0,0,0,0,0,0,0,0
2021-03-25,0,0,0,0,0,0,0,0,0
2021-03-26,0,0,0,0,0,0,0,0,0
