date,infected,exposed,active,recovered,deaths,diff_exposed,diff_active,diff_recovered,diff_deaths
2020-05-19,19757,4825,19757,0,0,0,0,0,0
2020-05-20,18982,3946,18982,0,0,0,0,0,0
2020-05-21,18101,3242,18101,0,0,0,0,0,0
2020-05-22,17159,2676,17159,0,0,0,0,0,0
2020-05-23,16187,2221,16187,0,0,0,0,0,0
2020-05-24,15210,1854,15210,0,0,0,0,0,0
2020-05-25,14247,1557,14247,0,0,0,0,0,0
2020-05-26,13309,1315,13309,0,0,0,0,0,0
2020-05-27,12405,1117,12405,0,0,0,0,0,0
2020-05-28,11541,955,11541,0,0,0,0,0,0
2020-05-29,10721,821,10721,0,0,0,0,0,0
2020-05-30,9946,711,9946,0,0,0,0,0,0
2020-05-31,9217,618,9217,0,0,0,0,0,0
2020-06-01,8533,541,8533,0,0,0,0,0,0
2020-06-02,7894,476,7894,0,0,0,0,0,0
2020-06-03,7298,421,7298,0,0,0,0,0,0
2020-06-04,6743,373,6743,0,0,0,0,0,0
2020-06-05,6228,333,6228,0,0,0,0,0,0
2020-06-06,5749,298,5749,0,0,0,0,0,0
2020-06-07,5305,268,5305,0,0,0,0,0,0
2020-06-08,4895,241,4895,0,0,0,0,0,0
2020-06-09,4514,218,4514,0,0,0,0,0,0
2020-06-10,4163,197,4163,0,0,0,0,0,0
2020-06-11,3838,179,3838,0,0,0,0,0,0
2020-06-12,3538,163,3538,0,0,0,0,0,0
2020-06-13,3261,148,3261,0,0,0,0,0,0
2020-06-14,3005,135,3005,0,0,0,0,0,0
2020-06-15,2769,124,2769,0,0,0,0,0,0
2020-06-16,2552,113,2552,0,0,0,0,0,0
2020-06-17,2351,104,2351,0,0,0,0,0,0
2020-06-18,2166,95,2166,0,0,0,0,0,0
2020-06-19,1995,87,1995,0,0,0,0,0,0
2020-06-20,1838,80,1838,0,0,0,0,0,0
2020-06-21,1693,73,1693,0,0,0,0,0,0
2020-06-22,1560,67,1560,0,0,0,0,0,0
2020-06-23,1437,62,1437,0,0,0,0,0,0
2020-06-24,1323,57,1323,0,0,0,0,0,0
2020-06-25,1219,52,1219,0,0,0,0,0,0
2020-06-26,1123,48,1123,0,0,0,0,0,0
2020-06-27,1034,44,1034,0,0,0,0,0,0
2020-06-28,952,41,952,0,0,0,0,0,0
2020-06-29,877,37,877,0,0,0,0,0,0
2020-06-30,808,34,808,0,0,0,0,0,0
2020-07-01,744,32,744,0,0,0,0,0,0
2020-07-02,685,29,685,0,0,0,0,0,0
2020-07-03,631,27,631,0,0,0,0,0,0
2020-07-04,581,25,581,0,0,0,0,0,0
2020-07-05,535,23,535,0,0,0,0,0,0
2020-07-06,493,21,493,0,0,0,0,0,0
2020-07-07,454,19,454,0,0,0,0,0,0
2020-07-08,418,18,418,0,0,0,0,0,0
2020-07-09,385,16,385,0,0,0,0,0,0
2020-07-10,355,15,355,0,0,0,0,0,0
2020-07-11,327,14,327,0,0,0,0,0,0
2020-07-12,301,13,301,0,0,0,0,0,0
2020-07-13,277,12,277,0,0,0,0,0,0
2020-07-14,255,11,255,0,0,0,0,0,0
2020-07-15,235,10,235,0,0,0,0,0,0
2020-07-16,216,9,216,0,0,0,0,0,0
2020-07-17,199,8,199,0,0,0,0,0,0
2020-07-18,184,8,184,0,0,0,0,0,0
2020-07-19,169,7,169,0,0,0,0,0,0
2020-07-20,156,7,156,0,0,0,0,0,0
2020-07-21,143,6,143,0,0,0,0,0,0
2020-07-22,132,6,132,0,0,0,0,0,0
2020-07-23,122,5,122,0,0,0,0,0,0
2020-07-24,112,5,112,0,0,0,0,0,0
2020-07-25,103,4,103,0,0,0,0,0,0
2020-07-26,95,4,95,0,0,0,0,0,0
2020-07-27,88,4,88,0,0,0,0,0,0
2020-07-28,81,3,81,0,0,0,0,0,0
2020-07-29,74,3,74,0,0,0,0,0,0
2020-07-30,68,3,68,0,0,0,0,0,0
2020-07-31,63,3,63,0,0,0,0,0,0
2020-08-01,58,2,58,0,0,0,0,0,0
2020-08-02,53,2,53,0,0,0,0,0,0
2020-08-03,49,2,49,0,0,0,0,0,0
2020-08-04,45,2,45,0,0,0,0,0,0
2020-08-05,42,2,42,0,0,0,0,0,0
2020-08-06,38,2,38,0,0,0,0,0,0
2020-08-07,35,2,35,0,0,0,0,0,0
2020-08-08,33,1,33,0,0,0,0,0,0
2020-08-09,30,1,30,0,0,0,0,0,0
2020-08-10,28,1,28,0,0,0,0,0,0
2020-08-11,25,1,25,0,0,0,0,0,0
2020-08-12,23,1,23,0,0,0,0,0,0
2020-08-13,22,1,22,0,0,0,0,0,0
2020-08-14,20,1,20,0,0,0,0,0,0
2020-08-15,18,1,18,0,0,0,0,0,0
2020-08-16,17,1,17,0,0,0,0,0,0
2020-08-17,16,1,16,0,0,0,0,0,0
2020-08-18,14,1,14,0,0,0,0,0,0
2020-08-19,13,1,13,0,0,0,0,0,0
2020-08-20,12,1,12,0,0,0,0,0,0
2020-08-21,11,0,11,0,0,0,0,0,0
2020-08-22,10,0,10,0,0,0,0,0,0
2020-08-23,9,0,9,0,0,0,0,0,0
2020-08-24,9,0,9,0,0,0,0,0,0
2020-08-25,8,0,8,0,0,0,0,0,0
2020-08-26,7,0,7,0,0,0,0,0,0
2020-08-27,7,0,7,0,0,0,0,0,0
2020-08-28,6,0,6,0,0,0,0,0,0
2020-08-29,6,0,6,0,0,0,0,0,0
2020-08-30,5,0,5,0,0,0,0,0,0
2020-08-31,5,0,5,0,0,0,0,0,0
2020-09-01,5,0,5,0,0,0,0,0,0
2020-09-02,4,0,4,0,0,0,0,0,0
2020-09-03,4,0,4,0,0,0,0,0,0
2020-09-04,4,0,4,0,0,0,0,0,0
2020-09-05,3,0,3,0,0,0,0,0,0
2020-09-06,3,0,3,0,0,0,0,0,0
2020-09-07,3,0,3,0,0,0,0,0,0
2020-09-08,3,0,3,0,0,0,0,0,0
2020-09-09,2,0,2,0,0,0,0,0,0
2020-09-10,2,0,2,0,0,0,0,0,0
2020-09-11,2,0,2,0,0,0,0,0,0
2020-09-12,2,0,2,0,0,0,0,0,0
2020-09-13,2,0,2,0,0,0,0,0,0
2020-09-14,2,0,2,0,0,0,0,0,0
2020-09-15,1,0,1,0,0,0,0,0,0
2020-09-16,1,0,1,0,0,0,0,0,0
2020-09-17,1,0,1,0,0,0,0,0,0
2020-09-18,1,0,1,0,0,0,0,0,0
2020-09-19,1,0,1,0,0,0,0,0,0
2020-09-20,1,0,1,0,0,0,0,0,0
2020-09-21,1,0,1,0,0,0,0,0,0
2020-09-22,1,0,1,0,0,0,0,0,0
2020-09-23,1,0,1,0,0,0,0,0,0
2020-09-24,1,0,1,0,0,0,0,0,0
2020-09-25,1,0,1,0,0,0,0,0,0
2020-09-26,1,0,1,0,0,0,0,0,0
2020-09-27,1,0,1,0,0,0,0,0,0
2020-09-28,0,0,0,0,0,0,0,0,0
2020-09-29,0,0,0,0,0,0,0,0,0
2020-09-30,0,0,0,0,0,0,0,0,0
2020-10-01,0,0,0,0,0,0,0,0,0
2020-10-02,0,0,0,0,0,0,0,0,0
2020-10-03,0,0,0,0,0,0,0,0,0
2020-10-04,0,0,0,0,0,0,0,0,0
2020-10-05,0,0,0,0,0,0,0,0,0
2020-10-06,0,0,0,0,0,0,0,0,0
2020-10-07,0,0,0,0,0,0,0,0,0
2020-10-08,0,0,0,0,0,0,0,0,0
2020-10-09,0,0,0,0,0,0,0,0,0
2020-10-10,0,0,0,0,0,0,0,0,0
2020-10-11,0,0,0,0,0,0,0,0,0
2020-10-12,0,0,0,0,0,0,0,0,0
2020-10-13,0,0,0,0,0,0,0,0,0
2020-10-14,0,0,0,0,0,0,0,0,0
2020-10-15,0,0,0,0,0,0,0,0,0
2020-10-16,0,0,0,0,0,0,0,0,0
2020-10-17,0,0,0,0,0,0,0,0,0
2020-10-18,0,0,0,0,0,0,0,0,0
2020-10-19,0,0,0,0,0,0,0,0,0
2020-10-20,0,0,0,0,0,0,0,0,0
2020-10-21,0,0,0,0,0,0,0,0,0
2020-10-22,0,0,0,0,0,0,0,0,0
2020-10-23,0,0,0,0,0,0,0,0,0
2020-10-24,0,0,0,0,0,0,0,0,0
2020-10-25,0,0,0,0,0,0,0,0,0
2020-10-26,0,0,0,0,0,0,0,0,0
2020-10-27,0,0,0,0,0,0,0,0,0
2020-10-28,0,0,0,0,0,0,0,0,0
2020-10-29,0,0,0,0,0,0,0,0,0
2020-10-30,0,0,0,0,0,0,0,0,0
2020-10-31,0,0,0,0,0,0,0,0,0
2020-11-01,0,0,0,0,0,0,0,0,0
2020-11-02,0,0,0,0,0,0,0,0,0
2020-11-03,0,0,0,0,0,0,0,0,0
2020-11-04,0,0,0,0,0,0,0,0,0
2020-11-05,0,0,0,0,0,0,0,0,0
2020-11-06,0,0,0,0,0,0,0,0,0
2020-11-07,0,0,0,0,0,0,0,0,0
2020-11-08,0,0,0,0,0,0,0,0,0
2020-11-09,0,0,0,0,0,0,0,0,0
2020-11-10,0,0,0,0,0,0,0,0,0
2020-11-11,0,0,0,0,0,0,0,0,0
2020-11-12,0,0,0,0,0,0,0,0,0
2020-11-13,0,0,0,0,0,0,0,0,0
2020-11-14,0,0,0,0,0,0,0,0,0
2020-11-15,0,0,0,0,0,0,0,0,0
2020-11-16,0,0,0,0,0,0,0,0,0
2020-11-17,0,0,0,0,0,0,0,0,0
2020-11-18,0,0,0,0,0,0,0,0,0
2020-11-19,0,0,0,0,0,0,0,0,0
2020-11-20,0,0,0,0,0,0,0,0,0
2020-11-21,0,0,0,0,0,0,0,0,0
2020-11-22,0,0,0,0,0,0,0,0,0
2020-11-23,0,0,0,0,0,0,0,0,0
2020-11-24,0,0,0,0,0,0,0,0,0
2020-11-25,0,0,0,0,0,0,0,0,0
2020-11-26,0,0,0,0,0,0,0,0,0
2020-11-27,0,0,0,0,0,0,0,0,0
2020-11-28,0,0,0,0,0,0,0,0,0
2020-11-29,0,0,0,0,0,0,0,0,0
2020-11-30,0,0,0,0,0,0,0,0,0
2020-12-01,0,0,0,0,0,0,0,0,0
2020-12-02,0,0,0,0,0,0,0,0,0
2020-12-03,0,0,0,0,0,0,0,0,0
2020-12-04,0,0,0,0,0,0,0,0,0
2020-12-05,0,0,0,0,0,0,0,0,0
2020-12-06,0,0,0,0,0,0,0,0,0
2020-12-07,0,0,0,0,0,0,0,0,0
2020-12-08,0,0,0,0,0,0,0,0,0
2020-12-09,0,0,0,0,0,0,0,0,0
2020-12-10,0,0,0,0,0,0,0,0,0
2020-12-11,0,0,0,0,0,0,0,0,0
2020-12-12,0,0,0,0,0,0,0,0,0
2020-12-13,0,0,0,0,0,0,0,0,0
2020-12-14,0,0,0,0,0,0,0,0,0
2020-12-15,0,0,0,0,0,0,0,0,0
2020-12-16,0,0,0,0,0,0,0,0,0
2020-12-17,0,0,0,0,0,0,0,0,0
2020-12-18,0,0,0,0,0,0,0,0,0
2020-12-19,0,0,0,0,0,0,0,0,0
2020-12-20,0,0,0,0,0,0,0,0,0
2020-12-21,0,0,0,0,0,0,0,0,0
2020-12-22,0,0,0,0,0,0,0,0,0
2020-12-23,0,0,0,0,0,0,0,0,0
2020-12-24,0,0,0,0,0,0,0,0,0
2020-12-25,0,0,0,0,0,0,0,0,0
2020-12-26,0,0,0,0,0,0,0,0,0
2020-12-27,0,0,0,0,0,0,0,0,0
2020-12-28,0,0,0,0,0,0,0,0,0
2020-12-29,0,0,0,0,0,0,0,0,0
2020-12-30,0,0,0,0,0,0,0,0,0
2020-12-31,0,0,0,0,0,0,0,0,0
2021-01-01,0,0,0,0,0,0,0,0,0
2021-01-02,0,0,0,0,0,0,0,0,0
2021-01-03,0,0,0,0,0,0,0,0,0
2021-01-04,0,0,0,0,0,0,0,0,0
2021-01-05,0,0,0,0,0,0,0,0,0
2021-01-06,0,0,0,0,0,0,0,0,0
2021-01-07,0,0,0,0,0,0,0,0,0
2021-01-08,0,0,0,0,0,0,0,0,0
2021-01-09,0,0,0,0,0,0,0,0,0
2021-01-10,0,0,0,0,0,0,0,0,0
2021-01-11,0,0,0,0,0,0,0,0,0
2021-01-12,0,0,0,0,0,0,0,0,0
2021-01-13,0,0,0,0,0,0,0,0,0
2021-01-14,0,0,0,0,0,0,0,0,0
2021-01-15,0,0,0,0,0,0,0,0,0
2021-01-16,0,0,0,0,0,0,0,0,0
2021-01-17,0,0,0,0,0,0,0,0,0
2021-01-18,0,0,0,0,0,0,0,0,0
2021-01-19,0,0,0,0,0,0,0,0,0
2021-01-20,0,0,0,0,0,0,0,0,0
2021-01-21,0,0,0,0,0,0,0,0,0
2021-01-22,0,0,0,0,0,0,0,0,0
2021-01-23,0,0,0,0,0,0,0,0,0
2021-01-24,0,0,0,0,0,0,0,0,0
2021-01-25,0,0,0,0,0,0,0,0,0
2021-01-26,0,0,0,0,0,0,0,0,0
2021-01-27,0,0,0,0,0,0,0,0,0
2021-01-28,0,0,0,0,0,0,0,0,0
2021-01-29,0,0,0,0,0,0,0,0,0
2021-01-30,0,0,0,0,0,0,0,0,0
2021-01-31,0,0,0,0,0,0,0,0,0
2021-02-01,0,0,0,0,0,0,0,0,0
2021-02-02,0,0,0,0,0,0,0,0,0
2021-02-03,0,0,0,0,0,0,0,0,0
2021-02-04,0,0,0,0,0,0,0,0,0
2021-02-05,0,0,0,0,0,0,0,0,0
2021-02-06,0,0,0,0,0,0,0,0,0
2021-02-07,0,0,0,0,0,0,0,0,0
2021-02-08,0,0,0,0,0,0,0,0,0
2021-02-09,0,0,0,0,0,0,0,0,0
2021-02-10,0,0,0,0,0,0,0,0,0
2021-02-11,0,0,0,0,0,0,0,0,0
2021-02-12,0,0,0,0,0,0,0,0,0
2021-02-13,0,0,0,0,0,0,0,0,0
2021-02-14,0,0,0,0,0,0,0,0,0
2021-02-15,0,0,0,0,0,0,0,0,0
2021-02-16,0,0,0,0,0,0,0,0,0
2021-02-17,0,0,0,0,0,0,0,0,0
2021-02-18,0,0,0,0,0,0,0,0,0
2021-02-19,0,0,0,0,0,0,0,0,0
2021-02-20,0,0,0,0,0,0,0,0,0
2021-02-21,0,0,0,0,0,0,0,0,0
2021-02-22,0,0,0,0,0,0,0,0,0
2021-02-23,0,0,0,0,0,0,0,0,0
2021-02-24,0,0,0,0,0,0,0,0,0
2021-02-25,0,0,0,0,0,0,0,0,0
2021-02-26,0,0,0,0,0,0,0,0,0
2021-02-27,0,0,0,0,0,0,0,0,0
2021-02-28,0,0,0,0,0,0,0,0,0
2021-03-01,0,0,0,0,0,0,0,0,0
2021-03-02,0,0,0,0,0,0,0,0,0
2021-03-03,0,0,0,0,0,0,0,0,0
2021-03-04,0,0,0,0,0,0,0,0,0
2021-03-05,0,0,0,0,0,0,0,0,0
2021-03-06,0,0,0,0,0,0,0,0,0
2021-03-07,0,0,0,0,0,0,0,0,0
2021-03-08,0,0,0,0,0,0,0,0,0
2021-03-09,0,0,0,0,0,0,0,0,0
2021-03-10,0,0,0,0,0,0,0,0,0
2021-03-11,0,0,0,0,0,0,0,0,0
2021-03-12,0,0,0,0,0,0,0,0,0
2021-03-13,0,0,0,0,0,0,0,0,0
2021-03-14,0,0,0,0,0,0,0,0,0
2021-03-15,0,0,0,0,0,0,0,0,0
2021-03-16,0,0,0,0,0,0,0,0,0
2021-03-17,0,0,0,0,0,0,0,0,0
2021-03-18,0,0,0,0,0,0,0,0,0
2021-03-19,0,0,0,0,0,0,0,0,0
2021-03-20,0,0,0,0,0,0,0,0,0
2021-03-21,0,0,0,0,0,0,0,0,0
2021-03-22,0,0,0,0,0,0,0,0,0
2021-03-23,0,0,0,0,0,0,0,0,0
2021-03-24,0,0,0,0,0,0,0,0,0
2021-03-25,0,0,0,0,0,0,0,0,0
2021-03-26,0,0,0,0,0,0,0,0,0
2021-03-27,0,0,0,0,0,0,0,0,0
2021-03-28,0,0,0,0,0,0,0,0,0
2021-03-29,0,0,0,0,0,0,0,0,0
2021-03-30,0,0,0,0,0,0,0,0,0
2021-03-31,0,0,0,0,0,0,0,0,0
2021-04-01,0,0,0,0,0,0,0,0,0
2021-04-02,0,0,0,0,0,0,0,0,0
2021-04-03,0,0,0,0,0,0,0,0,0
2021-04-04,0,0,0,0,0,0,0,0,0
2021-04-05,0,0,0,0,0,0,0,0,0
2021-04-06,0,0,0,0,0,0,0,0,0
2021-04-07,0,0,0,0,0,0,0,0,0
2021-04-08,0,0,0,0,0,0,0,0,0
2021-04-09,0,0,0,0,0,0,0,0,0
2021-04-10,0,0,0,0,0,0,0,0,0
2021-04-11,0,0,0,0,0,0,0,0,0
2021-04-12,0,0,0,0,0,0,0,0,0
2021-04-13,0,0,0,0,0,0,0,0,0
2021-04-14,0,0,0,0,0,0,0,0,0
2021-04-15,0,0,0,0,0,0,0,0,0
2021-04-16,0,0,0,0,0,0,0,0,0
2021-04-17,0,0,0,0,0,0,0,0,0
2021-04-18,0,0,0,0,0,0,0,0,0
2021-04-19,0,0,0,0,0,0,0,0,0
2021-04-20,0,0,0,0,0,0,0,0,0
2021-04-21,0,0,0,0,0,0,0,0,0
2021-04-22,0,0,0,0,0,0,0,0,0
2021-04-23,0,0,0,0,0,0,0,0,0
2021-04-24,0,0,0,0,0,0,0,0,0
2021-04-25,0,0,0,0,0,0,0,0,0
2021-04-26,0,0,0,0,0,0,0,0,0
2021-04-27,0,0,0,0,0,0,0,0,0
2021-04-28,0,0,0,0,0,0,0,0,0
2021-04-29,0,0,0,0,0,0,0,0,0
2021-04-30,0,0,0,0,0,0,0,0,0
2021-05-01,0,0,0,0,0,0,0,0,0
2021-05-02,0,0,0,0,0,0,0,0,0
2021-05-03,0,0,0,0,0,0,0,0,0
2021-05-04,0,0,0,0,0,0,0,0,0
2021-05-05,0,0,0,0,0,0,0,0,0
2021-05-06,0,0,0,0,0,0,0,0,0
2021-05-07,0,0,0,0,0,0,0,0,0
2021-05-08,0,0,0,0,0,0,0,0,0
2021-05-09,0,0,0,0,0,0,0,0,0
2021-05-10,0,0,0,0,0,0,0,0,0
2021-05-11,0,0,0,0,0,0,0,0,0
2021-05-12,0,0,0,0,0,0,0,0,0
2021-05-13,0,0,0,0,0,0,0,0,0
2021-05-14,0,0,0,0,0,0,0,0,0
