date,infected,exposed,active,recovered,deaths,diff_exposed,diff_active,diff_recovered,diff_deaths
2020-05-01,33560,9754,33560,0,0,0,0,0,0
2020-05-02,32551,7943,32551,0,0,0,0,0,0
2020-05-03,31272,6495,31272,0,0,0,0,0,0
2020-05-04,29820,5337,29820,0,0,0,0,0,0
2020-05-05,28267,4406,28267,0,0,0,0,0,0
2020-05-06,26665,3657,26665,0,0,0,0,0,0
2020-05-07,25056,3053,25056,0,0,0,0,0,0
2020-05-08,23469,2563,23469,0,0,0,0,0,0
2020-05-09,21923,2165,21923,0,0,0,0,0,0
2020-05-10,20434,1839,20434,0,0,0,0,0,0
2020-05-11,19011,1573,19011,0,0,0,0,0,0
2020-05-12,17660,1353,17660,0,0,0,0,0,0
2020-05-13,16383,1170,16383,0,0,0,0,0,0
2020-05-14,15182,1018,15182,0,0,0,0,0,0
2020-05-15,14056,891,14056,0,0,0,0,0,0
2020-05-16,13004,784,13004,0,0,0,0,0,0
2020-05-17,12022,693,12022,0,0,0,0,0,0
2020-05-18,11108,615,11108,0,0,0,0,0,0
2020-05-19,10259,549,10259,0,0,0,0,0,0
2020-05-20,9470,491,9470,0,0,0,0,0,0
2020-05-21,8739,441,8739,0,0,0,0,0,0
2020-05-22,8063,398,8063,0,0,0,0,0,0
2020-05-23,7437,359,7437,0,0,0,0,0,0
2020-05-24,6857,325,6857,0,0,0,0,0,0
2020-05-25,6322,295,6322,0,0,0,0,0,0
2020-05-26,5828,269,5828,0,0,0,0,0,0
2020-05-27,5372,245,5372,0,0,0,0,0,0
2020-05-28,4950,223,4950,0,0,0,0,0,0
2020-05-29,4562,204,4562,0,0,0,0,0,0
2020-05-30,4203,187,4203,0,0,0,0,0,0
2020-05-31,3873,171,3873,0,0,0,0,0,0
2020-06-01,3568,156,3568,0,0,0,0,0,0
2020-06-02,3287,143,3287,0,0,0,0,0,0
2020-06-03,3028,132,3028,0,0,0,0,0,0
2020-06-04,2789,121,2789,0,0,0,0,0,0
2020-06-05,2570,111,2570,0,0,0,0,0,0
2020-06-06,2367,102,2367,0,0,0,0,0,0
2020-06-07,2180,94,2180,0,0,0,0,0,0
2020-06-08,2008,86,2008,0,0,0,0,0,0
2020-06-09,1850,79,1850,0,0,0,0,0,0
2020-06-10,1704,73,1704,0,0,0,0,0,0
2020-06-11,1569,67,1569,0,0,0,0,0,0
2020-06-12,1445,62,1445,0,0,0,0,0,0
2020-06-13,1331,57,1331,0,0,0,0,0,0
2020-06-14,1226,52,1226,0,0,0,0,0,0
2020-06-15,1129,48,1129,0,0,0,0,0,0
2020-06-16,1040,44,1040,0,0,0,0,0,0
2020-06-17,958,41,958,0,0,0,0,0,0
2020-06-18,882,38,882,0,0,0,0,0,0
2020-06-19,812,35,812,0,0,0,0,0,0
2020-06-20,748,32,748,0,0,0,0,0,0
2020-06-21,689,29,689,0,0,0,0,0,0
2020-06-22,635,27,635,0,0,0,0,0,0
2020-06-23,584,25,584,0,0,0,0,0,0
2020-06-24,538,23,538,0,0,0,0,0,0
2020-06-25,496,21,496,0,0,0,0,0,0
2020-06-26,457,19,457,0,0,0,0,0,0
2020-06-27,420,18,420,0,0,0,0,0,0
2020-06-28,387,16,387,0,0,0,0,0,0
2020-06-29,357,15,357,0,0,0,0,0,0
2020-06-30,328,14,328,0,0,0,0,0,0
2020-07-01,303,13,303,0,0,0,0,0,0
2020-07-02,279,12,279,0,0,0,0,0,0
2020-07-03,257,11,257,0,0,0,0,0,0
2020-07-04,236,10,236,0,0,0,0,0,0
2020-07-05,218,9,218,0,0,0,0,0,0
2020-07-06,200,9,200,0,0,0,0,0,0
2020-07-07,185,8,185,0,0,0,0,0,0
2020-07-08,170,7,170,0,0,0,0,0,0
2020-07-09,157,7,157,0,0,0,0,0,0
2020-07-10,144,6,144,0,0,0,0,0,0
2020-07-11,133,6,133,0,0,0,0,0,0
2020-07-12,122,5,122,0,0,0,0,0,0
2020-07-13,113,5,113,0,0,0,0,0,0
2020-07-14,104,4,104,0,0,0,0,0,0
2020-07-15,96,4,96,0,0,0,0,0,0
2020-07-16,88,4,88,0,0,0,0,0,0
2020-07-17,81,3,81,0,0,0,0,0,0
2020-07-18,75,3,75,0,0,0,0,0,0
2020-07-19,69,3,69,0,0,0,0,0,0
2020-07-20,63,3,63,0,0,0,0,0,0
2020-07-21,58,2,58,0,0,0,0,0,0
2020-07-22,54,2,54,0,0,0,0,0,0
2020-07-23,49,2,49,0,0,0,0,0,0
2020-07-24,46,2,46,0,0,0,0,0,0
2020-07-25,42,2,42,0,0,0,0,0,0
2020-07-26,39,2,39,0,0,0,0,0,0
2020-07-27,36,2,36,0,0,0,0,0,0
2020-07-28,33,1,33,0,0,0,0,0,0
2020-07-29,30,1,30,0,0,0,0,0,0
2020-07-30,28,1,28,0,0,0,0,0,0
2020-07-31,26,1,26,0,0,0,0,0,0
2020-08-01,24,1,24,0,0,0,0,0,0
2020-08-02,22,1,22,0,0,0,0,0,0
2020-08-03,20,1,20,0,0,0,0,0,0
2020-08-04,18,1,18,0,0,0,0,0,0
2020-08-05,17,1,17,0,0,0,0,0,0
2020-08-06,16,1,16,0,0,0,0,0,0
2020-08-07,14,1,14,0,0,0,0,0,0
2020-08-08,13,1,13,0,0,0,0,0,0
2020-08-09,12,1,12,0,0,0,0,0,0
2020-08-10,11,0,11,0,0,0,0,0,0
2020-08-11,10,0,10,0,0,0,0,0,0
2020-08-12,10,0,10,0,0,0,0,0,0
2020-08-13,9,0,9,0,0,0,0,0,0
2020-08-14,8,0,8,0,0,0,0,0,0
2020-08-15,7,0,7,0,0,0,0,0,0
2020-08-16,7,0,7,0,0,0,0,0,0
2020-08-17,6,0,6,0,0,0,0,0,0
2020-08-18,6,0,6,0,0,0,0,0,0
2020-08-19,5,0,5,0,0,0,0,0,0
2020-08-20,5,0,5,0,0,0,0,0,0
2020-08-21,5,0,5,0,0,0,0,0,0
2020-08-22,4,0,4,0,0,0,0,0,0
2020-08-23,4,0,4,0,0,0,0,0,0
2020-08-24,4,0,4,0,0,0,0,0,0
2020-08-25,3,0,3,0,0,0,0,0,0
2020-08-26,3,0,3,0,0,0,0,0,0
2020-08-27,3,0,3,0,0,0,0,0,0
2020-08-28,3,0,3,0,0,0,0,0,0
2020-08-29,2,0,2,0,0,0,0,0,0
2020-08-30,2,0,2,0,0,0,0,0,0
2020-08-31,2,0,2,0,0,0,0,0,0
2020-09-01,2,0,2,0,0,0,0,0,0
2020-09-02,2,0,2,0,0,0,0,0,0
2020-09-03,2,0,2,0,0,0,0,0,0
2020-09-04,1,0,1,0,0,0,0,0,0
2020-09-05,1,0,1,0,0,0,0,0,0
2020-09-06,1,0,1,0,0,0,0,0,0
2020-09-07,1,0,1,0,0,0,0,0,0
2020-09-08,1,0,1,0,0,0,0,0,0
2020-09-09,1,0,1,0,0,0,0,0,0
2020-09-10,1,0,1,0,0,0,0,0,0
2020-09-11,1,0,1,0,0,0,0,0,0
2020-09-12,1,0,1,0,0,0,0,0,0
2020-09-13,1,0,1,0,0,0,0,0,0
2020-09-14,1,0,1,0,0,0,0,0,0
2020-09-15,1,0,1,0,0,0,0,0,0
2020-09-16,1,0,1,0,0,0,0,0,0
2020-09-17,0,0,0,0,0,0,0,0,0
2020-09-18,0,0,0,0,0,0,0,0,0
2020-09-19,0,0,0,0,0,0,0,0,0
2020-09-20,0,0,0,0,0,0,0,0,0
2020-09-21,0,0,0,0,0,0,0,0,0
2020-09-22,0,0,0,0,0,0,0,0,0
2020-09-23,0,0,0,0,0,0,0,0,0
2020-09-24,0,0,0,0,0,0,0,0,0
2020-09-25,0,0,0,0,0,0,0,0,0
2020-09-26,0,0,0,0,0,0,0,0,0
2020-09-27,0,0,0,0,0,0,0,0,0
2020-09-28,0,0,0,0,0,0,0,0,0
2020-09-29,0,0,0,0,0,0,0,0,0
2020-09-30,0,0,0,0,0,0,0,0,0
2020-10-01,0,0,0,0,0,0,0,0,0
2020-10-02,0,0,0,0,0,0,0,0,0
2020-10-03,0,0,0,0,0,0,0,0,0
2020-10-04,0,0,0,0,0,0,0,0,0
2020-10-05,0,0,0,0,0,0,0,0,0
2020-10-06,0,0,0,0,0,0,0,0,0
2020-10-07,0,0,0,0,0,0,0,0,0
2020-10-08,0,0,0,0,0,0,0,0,0
2020-10-09,0,0,0,0,0,0,0,0,0
2020-10-10,0,0,0,0,0,0,0,0,0
2020-10-11,0,0,0,0,0,0,0,0,0
2020-10-12,0,0,0,0,0,0,0,0,0
2020-10-13,0,0,0,0,0,0,0,0,0
2020-10-14,0,0,0,0,0,0,0,0,0
2020-10-15,0,0,0,0,0,0,0,0,0
2020-10-16,0,0,0,0,0,0,0,0,0
2020-10-17,0,0,0,0,0,0,0,0,0
2020-10-18,0,0,0,0,0,0,0,0,0
2020-10-19,0,0,0,0,0,0,0,0,0
2020-10-20,0,0,0,0,0,0,0,0,0
2020-10-21,0,0,0,0,0,0,0,0,0
2020-10-22,0,0,0,0,0,0,0,0,0
2020-10-23,0,0,0,0,0,0,0,0,0
2020-10-24,0,0,0,0,0,0,0,0,0
2020-10-25,0,0,0,0,0,0,0,0,0
2020-10-26,0,0,0,0,0,0,0,0,0
2020-10-27,0,0,0,0,0,0,0,0,0
2020-10-28,0,0,0,0,0,0,0,0,0
2020-10-29,0,0,0,0,0,0,0,0,0
2020-10-30,0,0,0,0,0,0,0,0,0
2020-10-31,0,0,0,0,0,0,0,0,0
2020-11-01,0,0,0,0,0,0,0,0,0
2020-11-02,0,0,0,0,0,0,0,0,0
2020-11-03,0,0,0,0,0,0,0,0,0
2020-11-04,0,0,0,0,0,0,0,0,0
2020-11-05,0,0,0,0,0,0,0,0,0
2020-11-06,0,0,0,0,0,0,0,0,0
2020-11-07,0,0,0,0,0,0,0,0,0
2020-11-08,0,0,0,0,0,0,0,0,0
2020-11-09,0,0,0,0,0,0,0,0,0
2020-11-10,0,0,0,0,0,0,0,0,0
2020-11-11,0,0,0,0,0,0,0,0,0
2020-11-12,0,0,0,0,0,0,0,0,0
2020-11-13,0,0,0,0,0,0,0,0,0
2020-11-14,0,0,0,0,0,0,0,0,0
2020-11-15,0,0,0,0,0,0,0,0,0
2020-11-16,0,0,0,0,0,0,0,0,0
2020-11-17,0,0,0,0,0,0,0,0,0
2020-11-18,0,0,0,0,0,0,0,0,0
2020-11-19,0,0,0,0,0,0,0,0,0
2020-11-20,0,0,0,0,0,0,0,0,0
2020-11-21,0,0,0,0,0,0,0,0,0
2020-11-22,0,0,0,0,0,0,0,0,0
2020-11-23,0,0,0,0,0,0,0,0,0
2020-11-24,0,0,0,0,0,0,0,0,0
2020-11-25,0,0,0,0,0,0,0,0,0
2020-11-26,0,0,0,0,0,0,0,0,0
2020-11-27,0,0,0,0,0,0,0,0,0
2020-11-28,0,0,0,0,0,0,0,0,0
2020-11-29,0,0,0,0,0,0,0,0,0
2020-11-30,0,0,0,0,0,0,0,0,0
2020-12-01,0,0,0,0,0,0,0,0,0
2020-12-02,0,0,0,0,0,0,0,0,0
2020-12-03,0,0,0,0,0,0,0,0,0
2020-12-04,0,0,0,0,0,0,0,0,0
2020-12-05,0,0,0,0,0,0,0,0,0
2020-12-06,0,0,0,0,0,0,0,0,0
2020-12-07,0,0,0,0,0,0,0,0,0
2020-12-08,0,0,0,0,0,0,0,0,0
2020-12-09,0,0,0,0,0,0,0,0,0
2020-12-10,0,0,0,0,0,0,0,0,0
2020-12-11,0,0,0,0,0,0,0,0,0
2020-12-12,0,0,0,0,0,0,0,0,0
2020-12-13,0,0,0,0,0,0,0,0,0
2020-12-14,0,0,0,0,0,0,0,0,0
2020-12-15,0,0,0,0,0,0,0,0,0
2020-12-16,0,0,0,0,0,0,0,0,0
2020-12-17,0,0,0,0,0,0,0,0,0
2020-12-18,0,0,0,0,0,0,0,0,0
2020-12-19,0,0,0,0,0,0,0,0,0
2020-12-20,0,0,0,0,0,0,0,0,0
2020-12-21,0,0,0,0,0,0,0,0,0
2020-12-22,0,0,0,0,0,0,0,0,0
2020-12-23,0,0,0,0,0,0,0,0,0
2020-12-24,0,0,0,0,0,0,0,0,0
2020-12-25,0,0,0,0,0,0,0,0,0
2020-12-26,0,0,0,0,0,0,0,0,0
2020-12-27,0,0,0,0,0,0,0,0,0
2020-12-28,0,0,0,0,0,0,0,0,0
2020-12-29,0,0,0,0,0,0,0,0,0
2020-12-30,0,0,0,0,0,0,0,0,0
2020-12-31,0,0,0,0,0,0,0,0,0
2021-01-01,0,0,0,0,0,0,0,0,0
2021-01-02,0,0,0,0,0,0,0,0,0
2021-01-03,0,0,0,0,0,0,0,0,0
2021-01-04,0,0,0,0,0,0,0,0,0
2021-01-05,0,0,0,0,0,0,0,0,0
2021-01-06,0,0,0,0,0,0,0,0,0
2021-01-07,0,0,0,0,0,0,0,0,0
2021-01-08,0,0,0,0,0,0,0,0,0
2021-01-09,0,0,0,0,0,0,0,0,0
2021-01-10,0,0,0,0,0,0,0,0,0
2021-01-11,0,0,0,0,0,0,0,0,0
2021-01-12,0,0,0,0,0,0,0,0,0
2021-01-13,0,0,0,0,0,0,0,0,0
2021-01-14,0,0,0,0,0,0,0,0,0
2021-01-15,0,0,0,0,0,0,0,0,0
2021-01-16,0,0,0,0,0,0,0,0,0
2021-01-17,0,0,0,0,0,0,0,0,0
2021-01-18,0,0,0,0,0,0,0,0,0
2021-01-19,0,0,0,0,0,0,0,0,0
2021-01-20,0,0,0,0,0,0,0,0,0
2021-01-21,0,0,0,0,0,0,0,0,0
2021-01-22,0,0,0,0,0,0,0,0,0
2021-01-23,0,0,0,0,0,0,0,0,0
2021-01-24,0,0,0,0,0,0,0,0,0
2021-01-25,0,0,0,0,0,0,0,0,0
2021-01-26,0,0,0,0,0,0,0,0,0
2021-01-27,0,0,0,0,0,0,0,0,0
2021-01-28,0,0,0,0,0,0,0,0,0
2021-01-29,0,0,0,0,0,0,0,0,0
2021-01-30,0,0,0,0,0,0,0,0,0
2021-01-31,0,0,0,0,0,0,0,0,0
2021-02-01,0,0,0,0,0,0,0,0,0
2021-02-02,0,0,0,0,0,0,0,0,0
2021-02-03,0,0,0,0,0,0,0,0,0
2021-02-04,0,0,0,0,0,0,0,0,0
2021-02-05,0,0,0,0,0,0,0,0,0
2021-02-06,0,0,0,0,0,0,0,0,0
2021-02-07,0,0,0,0,0,0,0,0,0
2021-02-08,0,0,0,0,0,0,0,0,0
2021-02-09,0,0,0,0,0,0,0,0,0
2021-02-10,0,0,0,0,0,0,0,0,0
2021-02-11,0,0,0,0,0,0,0,0,0
2021-02-12,0,0,0,0,0,0,0,0,0
2021-02-13,0,0,0,0,0,0,0,0,0
2021-02-14,0,0,0,0,0,0,0,0,0
2021-02-15,0,0,0,0,0,0,0,0,0
2021-02-16,0,0,0,0,0,0,0,0,0
2021-02-17,0,0,0,0,0,0,0,0,0
2021-02-18,0,0,0,0,0,0,0,0,0
2021-02-19,0,0,0,0,0,0,0,0,0
2021-02-20,0,0,0,0,0,0,0,0,0
2021-02-21,0,0,0,0,0,0,0,0,0
2021-02-22,0,0,0,0,0,0,0,0,0
2021-02-23,0,0,0,0,0,0,0,0,0
2021-02-24,0,0,0,0,0,0,0,0,0
2021-02-25,0,0,0,0,0,0,0,0,0
2021-02-26,0,0,0,0,0,0,0,0,0
2021-02-27,0,0,0,0,0,0,0,0,0
2021-02-28,0,0,0,0,0,0,0,0,0
2021-03-01,0,0,0,0,0,0,0,0,0
2021-03-02,0,0,0,0,0,0,0,0,0
2021-03-03,0,0,0,0,0,0,0,0,0
2021-03-04,0,0,0,0,0,0,0,0,0
2021-03-05,0,0,0,0,0,0,0,0,0
2021-03-06,0,0,0,0,0,0,0,0,0
2021-03-07,0,0,0,0,0,0,0,0,0
2021-03-08,0,0,0,0,0,0,0,0,0
2021-03-09,0,0,0,0,0,0,0,0,0
2021-03-10,0,0,0,0,0,0,0,0,0
2021-03-11,0,0,0,0,0,0,0,0,0
2021-03-12,0,0,0,0,0,0,0,0,0
2021-03-13,0,0,0,0,0,0,0,0,0
2021-03-14,0,0,0,0,0,0,0,0,0
2021-03-15,0,0,0,0,0,0,0,0,0
2021-03-16,0,0,0,0,0,0,0,0,0
2021-03-17,0,0,0,0,0,0,0,0,0
2021-03-18,0,0,0,0,0,0,0,0,0
2021-03-19,0,0,0,0,0,0,0,0,0
2021-03-20,0,0,0,0,0,0,0,0,0
2021-03-21,0,0,0,0,0,0,0,0,0
2021-03-22,0,0,0,0,0,0,0,0,0
2021-03-23,0,0,0,0,0,0,0,0,0
2021-03-24,0,0,0,0,0,0,0,0,0
2021-03-25,0,0,0,0,0,0,0,0,0
2021-03-26,0,0,0,0,0,0,0,0,0
2021-03-27,0,0,0,0,0,0,0,0,0
2021-03-28,0,0,0,0,0,0,0,0,0
2021-03-29,0,0,0,0,0,0,0,0,0
2021-03-30,0,0,0,0,0,0,0,0,0
2021-03-31,0,0,0,0,0,0,0,0,0
2021-04-01,0,0,0,0,0,0,0,0,0
2021-04-02,0,0,0,0,0,0,0,0,0
2021-04-03,0,0,0,0,0,0,0,0,0
2021-04-04,0,0,0,0,0,0,0,0,0
2021-04-05,0,0,0,0,0,0,0,0,0
2021-04-06,0,0,0,0,0,0,0,0,0
2021-04-07,0,0,0,0,0,0,0,0,0
2021-04-08,0,0,0,0,0,0,0,0,0
2021-04-09,0,0,0,0,0,0,0,0,0
2021-04-10,0,0,0,0,0,0,0,0,0
2021-04-11,0,0,0,0,0,0,0,0,0
2021-04-12,0,0,0,0,0,0,0,0,0
2021-04-13,0,0,0,0,0,0,0,0,0
2021-04-14,0,0,0,0,0,0,0,0,0
2021-04-15,0,0,0,0,0,0,0,0,0
2021-04-16,0,0,0,0,0,0,0,0,0
2021-04-17,0,0,0,0,0,0,0,0,0
2021-04-18,0,0,0,0,0,0,0,0,0
2021-04-19,0,0,0,0,0,0,0,0,0
2021-04-20,0,0,0,0,0,0,0,0,0
2021-04-21,0,0,0,0,0,0,0,0,0
2021-04-22,0,0,0,0,0,0,0,0,0
2021-04-23,0,0,0,0,0,0,0,0,0
2021-04-24,0,0,0,0,0,0,0,0,0
2021-04-25,0,0,0,0,0,0,0,0,0
2021-04-26,0,0,0,0,0,0,0,0,0
